NO ./assets/north_texture.xpm


SO ./assets/south_texture.xpm
EA ./assets/east_texture.xpm

WE ./assets/west_texture.xpm
F220,100,0


C255,255,0




1111111111111111111111
1111111111100000001111111
1000000000110000000000001
1011100111110001010000001
10010000110000010100N000111111
111111111011000100000000000001
111111111111111101111111111111
11110111111111010100000010001
11110111111111010101010010001
11111110110101010100000010001
10000000000000000100000100011
111111100000000001101010010001
110000011101010111110111100011
11110111111101011101111010001
11111111111111111111111111111
